0,1,2,3,4,5,6,7,8,9,10,11
1,0,1,1,0,1,1,0,1,1,1,1
1,0,1,1,0,0,0,0,1,1,1,1
1,0,1,1,0,1,1,0,1,1,1,1
1,0,1,1,0,1,1,0,1,1,1,1
0,0,1,1,0,1,1,0,1,1,1,1
1,0,1,1,0,1,1,0,1,1,1,1
1,0,1,1,10,1,1,0,1,1,1,1
5,0,1,1,0,1,1,0,0,0,0,3
1,0,1,1,0,1,1,0,1,1,1,1
1,0,1,1,0,1,1,0,1,1,1,1
1,0,0,0,0,0,0,0,2,4,0,0
1,0,1,1,1,1,1,1,1,1,0,1
