,0,1,2,3,4,5,6,7,8,9,10,11
0,1,1,1,1,1,1,1,1,1,1,1,1
1,0,10,0,0,0,0,0,3,0,0,0,0
2,1,0,1,1,1,1,1,1,1,1,1,1
3,1,0,1,1,1,1,1,1,1,1,1,1
4,0,0,0,0,0,0,0,0,0,0,0,0
5,1,1,1,1,0,1,1,0,1,1,1,1
6,1,1,1,1,0,1,1,0,1,1,1,1
7,0,0,0,0,0,0,0,0,4,0,0,2
8,1,0,1,1,1,1,1,1,1,1,1,1
9,1,0,1,1,1,1,1,1,1,1,1,1
10,1,0,0,0,0,0,0,0,0,0,0,0
11,1,0,1,1,5,1,1,1,1,1,0,1
